{
	"rows": {
		"a": "900000000",
		"b": "111111111",
		"c": "222222292",
		"d": "333333333",
		"e": "444444444",
		"f": "555955595",
		"g": "666666666"
		}
}