{
	"rows": {
		"a": "111111111",
		"b": "555555555",
		"c": "111111111",
		"d": "333333333",
		"e": "444444444",
		"f": "666666666",
		"g": "444444444"
		}
}