{
	"rows": {
		"a": "123111511",
		"b": "356555355",
		"c": "111111111",
		"d": "333333333",
		"e": "444447444",
		"f": "664646637",
		"g": "444444444"
		}
}