{
	"rows": {
		"a": "000000000",
		"b": "111111111",
		"c": "222222222",
		"d": "333333333",
		"e": "444444444",
		"f": "555555555",
		"g": "666666666"
		}
}